8.080808080808081495e-02
1.907216494845360710e-01
1.901408450704225317e-01
1.968085106382978788e-01
1.919831223628691852e-01
2.010582010582010470e-01
1.987860394537177555e-01
1.981258366800535409e-01
1.961722488038277479e-01
1.972132904608788762e-01
